05,05,20,21,05,05,10,05,05,05,20,21,05,05,05,05,05,10,05,05,05,05,05,05,05,05,05,05,05,05
05,05,30,31,05,05,05,05,05,05,30,31,05,05,05,05,05,05,05,05,05,05,05,05,05,05,05,05,05,05
05,05,05,05,05,05,05,05,05,05,01,01,05,05,05,05,05,22,05,05,05,05,05,05,05,05,05,05,05,05
05,05,05,05,05,05,05,05,05,01,01,01,05,05,05,05,05,32,05,05,05,05,05,05,05,05,05,05,05,05
05,05,05,05,05,05,05,05,01,01,01,01,05,05,05,05,05,22,05,05,05,05,05,05,05,05,05,05,05,05
05,05,05,05,05,05,05,01,01,01,01,01,05,05,05,05,05,32,05,05,05,05,05,05,05,05,05,05,05,05
05,05,05,05,05,05,01,01,01,01,01,01,05,05,05,05,05,22,05,05,05,05,05,05,05,05,05,05,05,05
05,05,05,05,05,01,01,01,01,01,01,01,05,05,05,05,05,01,05,05,05,05,05,05,05,05,05,05,05,05
00,00,00,00,05,00,00,00,00,00,00,00,00,00,00,00,00,00,00,00,00,00,00,00,00,00,00,00,00,00
00,00,00,00,05,00,00,00,00,00,00,00,00,00,00,00,00,00,00,00,00,00,00,00,00,00,00,00,00,00