05,05,20,21,05,05,10,05,05,05,20,21,05,05,05,05,05,10,05,05,05,05,05,05,05,05,05,05,05,05
05,05,30,31,05,05,05,05,05,05,30,31,05,05,05,05,05,05,05,05,05,05,05,05,05,05,05,05,05,05
05,05,05,05,05,05,05,04,05,05,05,05,05,05,05,05,05,05,05,05,05,05,05,05,05,05,05,05,05,05
05,05,05,05,05,05,05,05,05,05,05,05,05,05,05,05,05,05,05,05,05,05,05,05,05,05,05,05,05,05
05,05,05,05,05,05,05,05,05,05,05,05,05,05,05,05,05,05,05,05,05,05,05,05,05,05,05,05,05,05
05,05,05,05,04,05,05,04,05,05,04,05,05,05,05,05,05,05,05,05,05,15,05,05,05,05,05,05,05,05
05,05,05,05,05,05,05,05,05,05,05,05,05,05,05,06,07,05,05,05,24,25,26,05,05,05,05,05,05,05
05,05,12,13,05,05,05,05,05,05,05,05,05,05,05,16,17,05,05,33,34,35,36,37,05,05,05,05,05,05
00,00,00,00,00,00,00,00,00,00,00,00,00,00,00,00,00,00,00,00,00,00,00,00,00,00,00,00,00,00
00,00,00,00,00,00,00,00,00,00,00,00,00,00,00,00,00,00,00,00,00,00,00,00,00,00,00,00,00,00